1111111111111111
1001001000000001
1P0C0E10000000C1
1000000000000001
1111111111111111