1111111111111111111111111111111111
1E0000N00NN00000NNNN00000000000001
1010010100100000101001000N00010101
10100N00101N1010001001000000010101
1000000000000000000000000000000001
1000011111111111110000011111101111
1110000011111000000001111111000111
1E0N00000000N00000P000000000000001
1010010100N00N00101001000000010101
1010010010101010001001000000010101
100000000C00C000000000000N00000001
1111111111111111111111111111111111