111111111111111111
1P00000000C0000001
1000000000000000A1
1C00000000000000E1
111111111111111111