11111111111111
1P0101010101C1
10000000000001
10000000000001
10000001000011
11111111110111
10010010000001
100000000000C1
100001E1011111
11111111111111