11111111111111111
1P00000000C0000011
100000000000000001
1C00000000000000E1
111111111111111111